#S##################
#.....####.....#####
####..##############
####.#########.#####
####.#########.#####
####...#######.#####
######.#####...#####
#####..###..########
#.....####....######
##.##.##############
##.##........#######
##.#########.#######
##....######.#...###
#####.##..##.#######
#####.####...#######
#####.####.#########
##...............###
################.###
###..............###
###E################

####################
#.....####.....#####
####S.##############
####.#########.#####
####.#########.#####
####...#######.#####
######.#####...#####
#####..####....#####
#.....###........###
#####.##############
#####........#######
##......####.#######
############.#######
########..##.#...###
##########..########
##########.#########
##...............###
####################
###..............###
###E################